{
    "tiles" : [ [0, 0, 1, 1, 1, 0, 0 ],
                [0, 0, 1, 1, 1, 0, 0 ],
                [1, 1, 1, 1, 1, 1, 1 ],
                [1, 1, 1, 1, 1, 1, 1 ],
                [1, 1, 1, 1, 1, 1, 1 ],
                [1, 1, 1, 1, 1, 1, 1 ],
                [1, 1, 1, 1, 1, 1, 1 ],
                [0, 0, 1, 1, 1, 0, 0 ],
                [0, 0, 1, 1, 1, 0, 0 ] ],
    "score" : 2000,
    "move" : 15
}