{
    "tiles" : [ [1, 1, 1, 0, 1, 1, 1 ],
                [1, 1, 1, 0, 1, 1, 1 ],
                [1, 1, 1, 0, 1, 1, 1 ],
                [1, 1, 1, 0, 1, 1, 1 ],
                [0, 0, 0, 1, 0, 0, 0 ],
                [1, 1, 1, 0, 1, 1, 1 ],
                [1, 1, 1, 0, 1, 1, 1 ],
                [1, 1, 1, 0, 1, 1, 1 ],
                [1, 1, 1, 0, 1, 1, 1 ] ],
    "score" : 1000,
    "move" : 15
}