{
    "tiles" : [ [0, 0, 1, 1, 1, 1, 1, 0, 0 ],
                [0, 0, 1, 1, 1, 1, 1, 0, 0 ],
                [1, 1, 1, 1, 1, 1, 1, 1, 1 ],
                [1, 1, 1, 1, 1, 1, 1, 1, 1 ],
                [1, 1, 1, 1, 1, 1, 1, 1, 1 ],
                [1, 1, 1, 1, 1, 1, 1, 1, 1 ],
                [1, 1, 1, 1, 1, 1, 1, 1, 1 ],
                [0, 0, 1, 1, 1, 1, 1, 0, 0 ],
                [0, 0, 1, 1, 1, 1, 1, 0, 0 ] ],
    "targetMonster" : 20,
    "moves" : 15
}